25 20
#########
###@...###.
####...###
######.....#
####.........#
####.........#
####.........#
###..........#
####.........#
####.........#
####........#
####.........#
####........#
################













