50 50
#########
###@...###.
####...###
######.....#
####.........#
####.........#
####.........#
###..........#
####.........#
####.........#
####........#
####.........#
####........#
################            .                   ..
.
.
.
.
.
.
.
..
.
.
.
.
.
.
.
.
.
.
.
.
.
.
.
.
.
.
.
..
.
.
.
.
.
.
.














